1111111111111111
10010000000C0011
10000111110C0101
1P0011E0C0A00C01
100100C000000011
1111111111111111